10 20
1 1
10 20
-----------------------------------------
|     |     | |     | | |       |     | |
|-+ +-+-+ +-+ + +-+ + + +-+-+ +-+-+ + + |
|         |       |     | | | |   | |   |
| + +-+ + + +-+-+-+ + + + + + +-+ + + + |
| | |   |     |     | |     |       | | |
| +-+-+-+-+ +-+ +-+-+-+-+ +-+ + +-+-+ +-|
| | | |       |   | |         | |   |   |
| + + +-+ +-+-+ + + + +-+ +-+ + + + +-+ |
|     |     |   | |     | |   |   | | | |
|-+-+ +-+-+-+-+-+-+-+ +-+ +-+-+ +-+-+ +-|
| |   |   |     |     |     |   | | | | |
| +-+-+ +-+-+ +-+ + +-+-+ +-+ +-+ + + + |
|       |     | | |   |   | | | |       |
|-+ +-+ + + +-+ +-+-+ + +-+ + + +-+ +-+ |
|   | | | |     | | | | | | | |   | | | |
|-+ + +-+ + + + + + +-+ + + + + +-+-+ + |
|       | | | |     |     |             |
| + + +-+ + +-+-+-+ + +-+ + + +-+-+ +-+ |
| | |     | |           | | | |     |   |
-----------------------------------------
