50 100
1 1
50 100
---------------------------------------------------------------------------------------------------------------------------------------------------------------------------------------------------------
| |       |     |     |     |   |   |       |     | |       |     | |   |   |   |       |           |   |               |   |   | | | |     |                 |     | |   |           | |     |   | | | |
| + + +-+ +-+ +-+ +-+-+-+ + +-+ +-+ +-+ +-+ +-+ + + +-+ +-+ + + +-+ +-+ +-+ + + +-+ +-+ +-+ +-+ +-+ +-+ +-+-+-+-+ +-+-+ + +-+-+ + + + +-+ +-+ + +-+-+-+-+ + +-+-+-+ + + +-+ + +-+-+-+-+ +-+ +-+ +-+ + + |
| | |   |     | | |       |   |       | |   | | |   |   |     | |           | | |   |       | | | | |                 | |     |   |   |   |   | | |   |   | | | | |       | | |   |     |   |     |     |
| +-+-+ +-+-+-+ + + +-+-+ +-+ +-+ +-+-+ +-+ + + +-+-+ +-+-+-+ +-+ +-+-+-+-+ + +-+-+-+-+-+-+-+ +-+ + +-+-+ +-+ +-+ + +-+-+-+-+ + + + +-+ +-+-+ +-+ +-+ + +-+-+ + + +-+-+-+ +-+ +-+ + + + + + +-+-+ + + +-|
| |       | |       | | | | |             |     |   | | | |     |   | |   |     |               |     | | |   | | |   |         | | |   | |   | |   | |             |   |   |   |   | |   | |     | |   |
| +-+-+ +-+ + + +-+-+ + + + +-+ +-+ + +-+-+ +-+ + +-+ + + +-+ +-+ +-+ +-+ + +-+-+-+ + + + +-+-+-+-+ +-+ + +-+-+ +-+-+-+-+-+-+-+ +-+ + +-+ +-+ + + +-+ +-+ +-+ +-+-+ + +-+ + + +-+-+-+ + +-+ + +-+-+-+ +-|
|       | | | |     | |   |       | | | |   | | |   |     |   |   |     |   | |     | | | |         |   |     |       |       | |         |   |       |     |     | | |   |   |       |   | | | |       |
| +-+ + + + +-+-+ + + + + +-+ +-+-+ +-+ +-+-+ + + +-+-+-+-+ +-+-+ + + +-+-+ + +-+-+-+-+-+ +-+ + +-+ +-+ +-+ +-+ +-+ +-+ +-+ +-+ +-+-+ + + +-+-+-+-+-+ + + +-+-+ +-+ + + +-+-+ +-+ + +-+-+-+-+ + + +-+-+-|
| |   |       |   |   | | |     |   | | |   | |   |   | | | |   | | |     | |     |   |       | |       |       |   |   | | |     | | | |   |   |   |   | |   | |     |   |       | | | |   |       | | |
|-+-+ +-+-+-+ +-+-+-+-+-+-+ + +-+-+-+ + +-+ + + +-+-+ + + + + +-+ +-+ +-+ + + +-+-+-+ + +-+-+-+-+-+ +-+-+-+-+-+ +-+ +-+ + +-+-+ + + +-+-+-+ + +-+ + +-+ +-+ +-+ + + +-+ +-+ + + + +-+ + + +-+-+ + +-+ + |
|           |   |   | | |   | |   | |   |   | |   | |                 |   |     | | | |     | | |           |   |   | |       | |     |           | | |   | | | | |       | | | | |   | |       | |   | |
| +-+-+-+ +-+-+ + +-+ + +-+ +-+-+ + + +-+ +-+ + +-+ + +-+-+ +-+ +-+-+-+-+ + +-+-+ + + + + +-+ + +-+ +-+-+-+-+ +-+-+ + + +-+ +-+-+ +-+-+-+ + + +-+-+-+ + + + + +-+-+-+-+ + +-+-+ +-+ + + +-+-+ +-+ +-+ + |
|   |         | |   | |   |                 |       | | |   |   |       | |   |   |   | |         |       |       | | | | | | |     | |   | |       |   |   | | |     | |   | | |   |         |     |   |
|-+ + +-+-+-+ +-+-+ + + +-+-+-+ +-+-+-+-+ +-+ +-+-+-+ + +-+-+-+-+-+-+ + +-+-+-+-+ + +-+-+-+-+ +-+ +-+ +-+-+ +-+ +-+-+ +-+ + + +-+-+ + +-+ + +-+ + +-+ +-+-+ + + + + + +-+-+-+ +-+ +-+-+-+ +-+ +-+-+-+ +-|
| | |     |     | |         |       |     | | |   |     |             |   | | |           | |   | |       |   |   |     |   |   |   |   | | | | |   | | |   |     | |   |         |         |   | | |   |
| + +-+-+ +-+-+ + +-+-+-+ +-+-+ +-+-+-+-+ + +-+ +-+-+ +-+-+-+-+-+-+-+-+ +-+ + + + +-+-+-+-+ + + + + + +-+ +-+-+-+ + +-+-+ + + +-+ +-+ +-+-+ + + +-+-+-+ +-+ + +-+-+-+ + +-+-+-+ + +-+-+-+-+ +-+ + + +-+ |
| | | |   | |       | |       |   |       |                         | | |   |   |     |   | | | | | |   |     |         | |   |       | | | |               |     |   |     |   | | | |   | |     |   | |
| +-+ + +-+ + + + +-+ + + +-+-+-+-+-+ +-+ +-+-+-+-+ + +-+ +-+ +-+ + + + + +-+-+-+-+ + + + + +-+-+ +-+ +-+-+-+ + +-+ +-+ + + +-+-+-+ + + + +-+-+-+ +-+ + +-+ +-+-+ +-+-+-+-+-+ + + + + +-+ + + +-+-+-+ + |
|     | | | | | |     | |         | | | |   |       |   | | | | | |         |       |   |   |   | |     |     | |     |   |       | |       | |   |   | |   |       | |       | | |   | |   | |       | |
| + +-+-+ + +-+-+-+ +-+-+-+-+ +-+-+ + + +-+ +-+ +-+ + +-+ + +-+ +-+-+ + +-+-+-+-+-+-+-+ + +-+ +-+ +-+-+ + +-+ +-+-+ +-+ + +-+-+ +-+-+ +-+-+ + + + +-+ +-+-+ +-+ +-+-+ + +-+ +-+ +-+-+ + + + +-+ +-+-+ + |
| |       |   |   |     | | |     | |     |   | | | | | |   | |     | | |     | | |     |     | | | |   | |   |   |   | | |   | |       |   | | |   | | |             |   | | |   |     | |   |     |   |
|-+-+ +-+ + +-+-+ +-+-+ + + + + +-+ +-+-+-+-+ + + + +-+ +-+ + +-+-+ + + +-+ +-+ + + + + +-+ +-+ +-+ +-+ +-+-+ +-+ + +-+-+ + + +-+-+-+-+-+ +-+ +-+ +-+-+ +-+ +-+-+-+-+-+-+-+-+ +-+ +-+ +-+ + + + + + +-+ |
|   |   | |     |       |     |     |       | | |   |   |   |     |   | | |     |   | |   |   |   |     | |     |     | |   |     |   | |   |           |   | | |     | |       | | | |   | |   | |   | |
| + + +-+-+ + +-+-+-+ +-+-+ +-+-+-+ + +-+ + + +-+ +-+ + + +-+ + + +-+-+-+ +-+-+ + +-+ + +-+-+-+ +-+ + +-+ +-+-+ +-+ +-+ +-+-+-+ +-+ + + + +-+ +-+-+-+-+ +-+ + + +-+ + + + +-+ +-+ + + +-+ +-+ + +-+-+-+-|
| |     |   |         |     |           | |     |   | |       | |     |       |   |   | | |         |   |   | |         |     |     | |     | |       | | | |       |   | |   | |   |       | | | | |   |
| + + +-+ +-+ + +-+-+-+-+-+-+-+-+-+-+ + + +-+-+-+ +-+-+-+ +-+-+-+ +-+ + + +-+ + +-+-+ + + + +-+ +-+-+-+-+ +-+ +-+ + +-+ +-+ + +-+-+ +-+-+ +-+ +-+-+ +-+ + +-+-+ +-+-+ +-+ +-+ + +-+ + +-+-+-+ + + + + +-|
| | |       | |           |       | | | |   |   |     | | | |     |   | | |   |   | | | |     |   |       |       | |       |     |   | |   |       | | | | |   |       | |   |     |       | |         |
|-+-+ +-+-+-+ + + + + +-+-+-+-+-+ + + +-+-+-+-+ +-+-+-+ +-+ + + + +-+-+-+ +-+-+ +-+ +-+ +-+ +-+-+ + +-+-+-+-+-+-+-+-+-+-+ + + + +-+ +-+ + +-+ +-+-+ + + + + +-+ +-+ +-+-+ + + + + + + +-+ + + +-+ +-+-+-|
| | |     |   | | | |   |   |     |   |     |     | | | | |   | | | |             | |   | | |     | |       |     |   |   | | | | |           |     |       |     |   |   | |   | | |   | | | |   |   | |
| + +-+ + +-+-+ + + +-+-+-+ +-+-+ + +-+-+ +-+ +-+-+ + + + + +-+-+ + + + +-+ +-+-+-+ + + + +-+-+ + + + +-+ +-+-+-+ +-+ +-+ +-+-+-+ + +-+-+ +-+-+-+ +-+-+ + +-+-+ +-+-+-+-+ +-+-+ +-+-+-+-+ + +-+ +-+-+ + |
|   |   |   | | | | |     |   |       |       |     | |       |   |   |   |         | |   |     |     |           |           | |     |         |   | | | | |       |     |   | | |     | |   | | | |   |
| + + +-+ +-+ +-+-+-+-+ +-+-+ + +-+-+ + +-+ +-+-+-+ + + + + +-+-+-+ + +-+-+ +-+-+-+-+-+ +-+ +-+ +-+-+-+-+ + + + +-+-+-+-+ +-+-+ +-+-+-+-+ + +-+-+ +-+ +-+ + + + + +-+ +-+ + +-+ + + + +-+-+-+ + + + +-+ |
| |     |   | |       |             |   |             | | | | |     |   | |     |   |   | | |   |   |     | | |     |               |     | |     | |         | |       | |         |       | |   | |   |
|-+-+-+ + +-+ +-+ + +-+-+-+ + + +-+-+-+-+-+ +-+-+ +-+-+ +-+-+ +-+-+ +-+-+ + + +-+ +-+ + + + +-+ +-+ +-+ +-+-+-+-+ + +-+-+ + +-+ +-+-+-+ + + +-+ +-+ + +-+-+-+-+ + +-+-+ +-+ +-+ +-+ +-+-+ +-+-+-+ + +-+ |
|       |   |     | |     | | |     |     |   | | |           |   |     |   |   |     | | | | |   | |   |       | | |   | |   | |   | | | | |   |       | |   | |   | |   | | |   | |   |     |     |   |
| +-+ +-+ +-+-+ + + + + + + +-+-+ +-+ +-+-+-+ + + + + +-+-+-+-+-+ +-+-+ +-+ +-+-+ + +-+-+ + + +-+-+ +-+-+ + +-+-+ +-+-+ +-+ +-+ +-+ + +-+ +-+ +-+-+ +-+-+ +-+ +-+-+ + +-+-+ + +-+ +-+ + + +-+ + +-+-+ +-|
| | |   |       | |   | | |   |     |         | |   | |         |       |     |   |   |   |     | | |     |   |     |   |   | | | |   |     |     | |   | |       |   |       |     | |   | | | |       |
|-+ +-+ + +-+-+-+-+-+-+ +-+-+-+-+ +-+-+-+ +-+ + +-+ +-+ +-+-+ +-+-+ +-+ +-+ +-+ +-+-+ + + +-+-+-+ + +-+ +-+ +-+-+ +-+ +-+ +-+ +-+ + +-+ +-+-+-+ +-+-+ +-+ + +-+-+-+ +-+-+-+-+-+-+ +-+ +-+-+ +-+-+-+-+-+ |
|   |   |     |   |     | |       | |       | |     | |   |           | |   |     | |   | | | |       | |   |     |     | |     |   |       | |     |   |     |     | |         |   |     |       |     |
|-+ + +-+-+-+ +-+ +-+ +-+ +-+-+-+-+ +-+-+ +-+-+ +-+-+ +-+-+-+-+ +-+-+ + + + +-+-+ + +-+-+-+ + + +-+-+ + + +-+-+-+-+ + +-+ +-+-+ +-+ +-+ +-+ + + +-+ +-+ + + +-+ + + + + +-+-+-+ + +-+ + +-+ +-+-+ + +-+-|
|     |       | |     |   | |   | |   |       |           |     | | | | | |     |   |       | | |   |   | | |   | | | | | | | | |     |   | |   |     |   | | | | | |       | | |   | | |     |     |   |
|-+ +-+-+-+-+ + + +-+ + +-+ + +-+ +-+ + +-+-+-+-+-+-+ +-+ +-+ + + + +-+-+-+ +-+ +-+-+ +-+-+ + +-+ +-+ +-+ + + +-+ +-+ + +-+ + + + + +-+-+ + +-+-+-+-+ +-+ +-+ +-+-+-+ +-+ + + +-+ +-+-+-+ + +-+-+ + + + |
|     |   | | |     |       |           |   | | |       |     |     | |     |   | | | | |     |         | | | | |   |   | |   |   | |     | | |             |       |   | | | |   | | | | |     | | | | |
|-+ +-+ +-+ +-+-+-+ + +-+-+-+ +-+-+-+-+ +-+ + + +-+-+ +-+-+-+ + + +-+ +-+-+ + +-+ + + + +-+-+ +-+ +-+ +-+-+ + + + +-+ +-+ + +-+-+-+ +-+ + + + +-+-+-+-+ +-+-+-+-+ +-+-+ + + + + +-+ + + +-+ +-+-+ +-+ +-|
| | |     |   |     | |   | |   |     | |   |   | |   |   |   | |     |   | |       |   |       | | | | |   |     | |       |           | | |   |   |             |     | |             |   | |   | |   |
| +-+ +-+-+ + + +-+-+ +-+ + + +-+-+-+ +-+ +-+ +-+ + +-+ +-+ +-+-+-+ +-+ +-+-+ +-+ +-+-+-+ +-+ + + + + + + + +-+-+ + +-+-+-+ +-+-+ + +-+ + +-+-+ +-+ + +-+-+ + +-+-+ + +-+ + + + +-+-+-+-+ +-+ + +-+ + +-|
|           | | |   |     | |     |     |       | | | |       |     |           | |   |   | | | | | | |   |       |     |   |     | |   | |   |     | | |   | |   | | |   | | |         | |     |       |
|-+ +-+ +-+-+ +-+ + +-+-+ + + + + + +-+ + + +-+ + + + +-+-+-+-+ +-+ + +-+-+-+-+ + +-+ +-+ + +-+-+-+ + + +-+-+ +-+-+-+ +-+ +-+ + +-+-+-+ +-+-+ + +-+ +-+ +-+ +-+-+ +-+ +-+ + +-+ + +-+-+-+ +-+-+ + + +-+-|
| |   | |       | | |         | | | |   | | |   | |   | | | |   |   | | | |   | | |     |     |   |     |     |   |       | | |   |   | | |   |   |                 |   | |   | |     |   | | | | |     |
| +-+-+ + + + +-+-+ + +-+-+-+ +-+ + +-+-+-+-+-+ + +-+-+ + + + +-+ +-+-+ + +-+ +-+-+ + +-+ +-+ + +-+ + + +-+-+ + +-+-+ + +-+ +-+-+ + +-+-+ + + +-+-+-+ +-+ + +-+-+-+ + +-+-+-+-+-+-+-+ + +-+ + +-+ +-+ + |
| |   | | | |     |   |         |   | |   | |     |       | | | |         |   | | | |   | |         | |   |   | |   | |             | |     | |         | | |   | | |     | | |   |                 | | |
| +-+ +-+ +-+-+ +-+ +-+ +-+-+ +-+-+ + + + + +-+-+ + +-+-+-+ + + +-+-+ + +-+-+ + + + +-+ +-+-+-+-+-+ +-+ + +-+ + + +-+ +-+-+-+-+ +-+ + +-+ + + +-+-+ + +-+-+-+-+ + +-+ + +-+ + +-+ +-+ +-+-+-+ +-+-+ +-+-|
|   |       | | |     |     |   | |   | |   | | |     |       |     | |       |       | |           |   | |   |   | | | | |   |   |       | | |   | |   | | |     |   |     |     | |     | | |   | |   |
| + +-+-+ +-+ + + + +-+-+-+ +-+ + + +-+-+-+ + + +-+ +-+-+-+ + + +-+-+ +-+-+-+-+ +-+-+ +-+-+-+ +-+-+-+ + +-+ +-+ +-+ + + + + +-+-+-+ + + +-+-+-+ +-+ + +-+ + + +-+-+-+-+-+-+-+ +-+-+ + +-+-+ + +-+ +-+ + |
| |         |     | |     | |     | |         |     |   |   | |       |   |       | |     | |   |   | |   |   |   |     |       |   | | | |   |     | |   | |         |     | |     | | |             | |
| +-+ +-+-+ +-+-+ + +-+-+ +-+ + +-+-+-+ + + +-+ +-+ + + +-+-+-+ + + +-+ + + +-+-+ + + +-+ + +-+-+-+ + + + +-+ + +-+-+-+ + +-+-+-+ + +-+ + +-+ +-+ + +-+-+ + +-+ + +-+-+-+ +-+ + +-+ +-+ + + +-+-+-+ + + |
| |     | | |     | | |     | | |   | | | |     |   | |   |     | |   | |       | |   |   |   |       | | |     |             |   |   | |   | |   |   |   | |   |     |   |     |   |     |   |     | | |
| +-+-+-+ +-+-+-+-+ + + +-+-+-+-+ +-+ +-+ +-+ + +-+ +-+ +-+ +-+ +-+-+-+ +-+ +-+ +-+ +-+-+ +-+ + +-+-+ +-+-+-+ +-+-+ + +-+ +-+-+ +-+-+-+ + +-+ +-+-+-+ +-+ + + +-+ +-+-+-+ + +-+-+-+ + + + +-+ +-+-+ +-+ |
|   |   | |       |   |             |       | |   | |         |         | |   | |       | | | | |       |         | |   | | |   |   | |   | | |     | | |       | |     | |     |   | | | |   |   |   | |
| +-+-+ + +-+ +-+-+ + +-+-+ + + + +-+ + +-+-+-+ +-+-+ + +-+-+-+-+-+ +-+-+ +-+ + +-+ +-+ + + + +-+ + +-+-+ + + + + + +-+-+-+ +-+-+-+ + +-+-+ + + + +-+-+ +-+ +-+ + + + + + +-+-+-+ + +-+-+-+ +-+ + + + + |
|   | |     | |   | |   |   | | |     | |   | | | |   | | | |         |   |   | | |   | |       | |     | | | | |         |     |     |     | | |   |   | |   | |   | |     |   | |     | |     | | | | |
|-+ + +-+ +-+ + + +-+ +-+ + +-+ +-+ +-+-+ + + +-+ +-+ +-+ + +-+-+-+-+ +-+ +-+ +-+ + + +-+-+-+ + +-+-+ + +-+ + + + + +-+ +-+-+-+ +-+-+ +-+ +-+ +-+-+ + +-+ +-+-+ +-+-+-+-+-+-+ +-+-+-+-+ + +-+ +-+-+ +-+-|
|     | |   |   |       | | |   | |     | |   |   | | |     |   | | | |         |   |   | |   |   |   | |   | | | | | |           | | |     | |     |       |     |         | |   |             |   |   |
| + +-+ + +-+-+-+ +-+ +-+ +-+ +-+ + +-+-+ +-+-+-+ + +-+-+ + + +-+ + +-+ +-+-+-+-+-+-+-+ + +-+-+ +-+-+-+-+ + + +-+-+-+ +-+-+-+ +-+-+ + + +-+-+ + +-+-+ +-+-+ + +-+-+ + +-+ + + +-+ + + +-+-+-+ +-+-+-+-+ |
| | |       |   | |       | |   | |       |   | | |   | | | |   |   |     |   |       |   | |             | |   |         |   | |     |       |   | | | |   | | | | |   | |   |   | |   |   |   |   | | |
|-+-+ +-+-+-+-+ + +-+ +-+ + +-+-+ +-+-+-+ + +-+ + + + + +-+ +-+ +-+ +-+ +-+ +-+-+-+ +-+ + + +-+ + + +-+-+-+-+ +-+ +-+ +-+ +-+ + + + + +-+-+ +-+ +-+ +-+ +-+ + + + +-+ + +-+-+-+ +-+-+ +-+-+ +-+ +-+ + + |
| | |     |       | |   | |   |     | |       |     | |   |   |       | | |     |   | | |   | | | | | | | | |   |   | |   |   |   | |   | |   |   |   | |     | | |   |     | |       |   |     | | |   |
| + + + +-+-+-+-+ + +-+-+ +-+ +-+-+ + +-+-+-+-+ + + +-+-+ +-+ + +-+-+ + + +-+ +-+-+ + + +-+ + +-+-+ + + + + +-+-+ +-+-+ + +-+-+ +-+-+-+ + + +-+-+ +-+ + + + +-+ + +-+ + +-+-+ + +-+ +-+ +-+ +-+ + + + + |
|     | |     |       |               |       | | |     |       | |   | | |           |   | |     |       | |     |   | |   |   | |     | | |   |     | | |     | | | |       | |     |   |   | |   | | |
|-+-+ +-+-+-+ +-+ + + +-+-+ +-+-+-+-+-+ +-+-+ +-+-+ +-+-+ +-+ +-+ + +-+-+ + + + + +-+-+ +-+ +-+ +-+-+ + +-+ +-+-+ + +-+-+ +-+-+ + +-+-+ + + + +-+ +-+ + + +-+-+-+ + + +-+-+-+ + + + +-+ + + +-+-+ + + +-|
|     | |   |     | | |   | |   |       | | |   | | |     |     |     | | | | | |     | |         |   |   |   | |       |           |         | | |   |   |       | | | | |     | | | | |       | |     |
|-+-+ + + +-+ +-+-+-+-+ + +-+-+ +-+ +-+-+ + +-+-+ + +-+ +-+ + + +-+ + + + +-+-+-+-+ +-+ +-+-+ +-+-+ +-+-+-+ + + + + + + +-+-+ +-+ + +-+-+ +-+-+ +-+ +-+-+ + +-+ +-+ +-+ + +-+-+ +-+ + +-+-+ +-+ + +-+ + |
| | | |     | |   |   | |             | | |   |   | |     | | |   | |       | |   | |   | |   |       | |   | |   | | | | |     | | |     |     |   |   |     | |     |       | |       | |   |     | | |
| + + +-+ +-+-+ + +-+ +-+-+ + +-+ +-+-+ + + +-+ + + +-+-+ + +-+ +-+ +-+-+ +-+ + +-+ + +-+ + + +-+-+-+ + +-+ +-+-+-+-+ +-+ +-+ +-+ + + + + +-+ +-+ +-+-+ + +-+ + + +-+-+ +-+-+ +-+ +-+-+-+ +-+-+-+-+-+-+-|
|           |   | | | | |   | |               | |         |   | |     |     |         |     |   |   | |     |   | |     |       | | | | | |   | |     |     | |     | |     | |   | |     |           | |
|-+-+ +-+-+ +-+-+ + + + +-+ +-+ + +-+-+-+-+ + +-+-+ +-+ + +-+-+-+ +-+-+ +-+-+-+-+-+-+-+ +-+-+ +-+-+ + + + + +-+ + + + +-+-+ +-+-+-+ + +-+-+ + + +-+ +-+ +-+-+-+ +-+-+ + +-+-+-+ + + + +-+-+-+ + +-+ +-+ |
|   | |         |   | |   |   | | |       | |     |   | | | | |   | |     |       |     |   |   |       | | | |   | | |   |     | | | |     | |   |         | |       |   |   | |     |   | | |   |   | |
|-+ +-+-+-+ +-+ + +-+ +-+ +-+ + +-+ + + +-+-+ + + +-+-+ +-+ + +-+-+ +-+ +-+-+-+-+ + +-+ +-+ +-+-+-+-+ +-+ + + + + + +-+-+ + + + + +-+ +-+-+ + +-+ +-+ + +-+-+ +-+ +-+ + +-+ +-+ +-+ + +-+ + +-+ +-+ + + |
|     |   | | |             | |   | | |     | | |   |       |       |         |     |       |   | |   | | | |   | |   |   | | |     | |   | |         | |   | |   |     |   | |   | |   |   | | |   |   |
| + +-+-+ + + +-+ +-+ +-+-+-+ + +-+-+ +-+ + +-+ + +-+ + +-+ +-+-+-+ + +-+-+ +-+-+-+-+ + +-+-+ +-+ +-+-+ + +-+-+-+ +-+ +-+ +-+ + + +-+ + + +-+ + +-+ +-+-+ + + +-+ + + +-+ +-+ + +-+-+-+ +-+ + + + +-+-+-|
| |   |     |   |   |       | |   | | |   |     |   | | |   | |           |     | | | |   |       |   |     |     | | | | |   | |   |   |   | |   |   | | |   |   | |   |   |         |         | |     |
| +-+-+ +-+-+ + + +-+-+-+ +-+ +-+-+ + + + +-+ +-+-+ +-+ + + + + + +-+-+-+-+ +-+-+ + + +-+-+ +-+ + + + + +-+-+ +-+-+ +-+ + + +-+-+ + +-+ +-+ + +-+ +-+ + +-+-+ +-+ + +-+ + +-+-+ +-+-+-+-+-+ +-+ + + + + |
|       |   | |   |   |     |   |   | | |   | | |       | | | | |   | | |       |   |     | |   |   | |   | | |       | |     | | |   |   | | |   | |   |       | | | |     | |     |   |   |   | | | | |
|-+-+-+ + +-+-+-+ +-+ + + + +-+-+ +-+ +-+-+-+ + +-+ + +-+-+ + +-+ + + + +-+-+ + + + + +-+-+ +-+-+ + +-+ + + + + +-+-+-+ +-+-+ + +-+-+ +-+-+ + +-+ + + + +-+ + +-+-+-+ +-+ + + + +-+ + +-+ +-+-+ +-+-+ +-|
|     |       | | | |   | | |   |   | |   |     |   | |     | |   | |   |   | |   |     | |   |   |   | | |             |           |   | |   |     | |   | |   |         |     | | |     | |           |
| +-+ + +-+ +-+ +-+ +-+ +-+ + + + + +-+ +-+-+ + + + +-+-+ + + + + + + +-+ +-+-+-+-+-+-+-+ +-+ +-+-+-+-+-+ +-+ +-+ +-+-+-+ +-+ + + +-+-+-+ +-+-+-+-+-+-+-+ + + +-+-+-+-+ +-+-+ +-+ + + +-+-+ +-+-+-+ + +-|
| |   |   |       |   | | | | | | |       |   | | |   |   | |   | |             |       |             |   |     |   | | |   | | |         |   |   | |   |   |   | |     |     |     |     |   | |   |   |
| +-+-+-+-+-+-+ +-+ +-+ + +-+ +-+-+-+ +-+ + + +-+-+-+ + + +-+ +-+ + + + +-+ + + +-+ +-+ +-+-+ +-+ +-+-+ +-+-+ + +-+ + + + + +-+-+-+-+-+ +-+-+ + +-+ + + +-+-+-+-+ +-+-+ +-+ +-+ +-+ +-+-+ + +-+ +-+ + + |
|             |   |     |       |   | |     | |       | |   | |   | | | |   | |   | |   |   | |     |     |   | |     |   |       | |           | |   | | | | |       | |   | |   | |   | |   |     | | |
| +-+-+-+-+ + + +-+-+-+-+ +-+ +-+ +-+-+-+ +-+-+-+-+-+-+-+ +-+-+-+ +-+ + +-+-+ +-+-+ + +-+ +-+-+ +-+ +-+-+ +-+-+-+ + + +-+-+ +-+-+ + +-+ +-+ + +-+ + +-+-+ + + +-+ +-+ +-+ + + +-+ +-+ + + +-+ +-+-+ +-+-|
| |   |     | | | |   |   |   |         |   |     |   | | |     | |   | | | | | |   |       |     |     |       | | |         | |     | | | |         |     | | |   | |   |     |   | |   |   |         |
| + +-+-+-+-+-+ + + +-+-+ + +-+ + +-+ +-+ +-+ +-+ + +-+ +-+ + +-+-+-+ + + + +-+ +-+ +-+-+ +-+ +-+ +-+-+-+-+ +-+-+ + +-+ +-+ + + +-+-+-+-+ + +-+-+ +-+-+-+-+ + + + +-+ +-+-+ +-+-+ +-+-+ + +-+ +-+ + +-+-|
|   | |   | |         |   |   | | | |   | | |   |   |       |   | |   | | |   |   |   |     | |     | | |   |     |   | | | | | |   |       | |   |     |     |   |           |   |   | |     |   |     |
|-+ + + +-+ + + + +-+ + + +-+ + + + +-+-+ + +-+-+-+ +-+ + + +-+-+ +-+ +-+ + +-+ +-+ + + + +-+ +-+-+-+ + + +-+ + +-+-+ +-+ + +-+ +-+ +-+-+-+ + +-+ + +-+-+ + + +-+ + + +-+ + +-+-+ +-+ + +-+ +-+-+-+ + +-|
|       |   | | |   |   | |     |   |   | |     |       | | |     | |         |     | | |   | |   | | |     | | |   |     |   |                 |     |   | |     | | |   |   |       | |   | |     |   |
| +-+-+ + + +-+-+-+ +-+ + + + +-+-+ +-+ + + + +-+ +-+-+-+ + +-+ +-+ + +-+-+-+-+-+ + + +-+ + + + +-+ + + +-+-+-+-+-+ + + + +-+-+ +-+-+ +-+-+ + + +-+-+ + + +-+ +-+ +-+-+ +-+ +-+-+-+ +-+-+-+-+ +-+ +-+ +-|
|   |     |   |     |   | | |   |         | |           | | |   | |   |       |   | | | | | |     | |   |   |   | | | | | |         |   |   | | |     | |   | |       | |   |         |           |     |
| + + + +-+-+ +-+-+ + + + +-+ +-+ +-+-+-+-+ +-+-+ +-+-+-+-+ + + + +-+ + + +-+ +-+-+ +-+ + + +-+-+ + + +-+ + +-+ + + +-+-+ + +-+ +-+ + +-+ +-+-+-+ + +-+-+ +-+-+-+-+-+ +-+ +-+-+-+-+ + + + +-+-+-+ + + + |
| | | |   |         | | | |   |     |       |             |   |         | |           |   |     |         |     |         |   |   | | |   |       |   |             | |       |     | | |     |   | | | |
---------------------------------------------------------------------------------------------------------------------------------------------------------------------------------------------------------
